1111111111111
11110C1000E01
110C000P01101
1111111111111
