1111111111111111111111111111111111
1C1000000000000C10000C000000000001
1010C10100100000101001000110010101
101111001010101000100111100C010101
10P000000C00C0100000000000000010E1
1111111111111111111111111111111111
