1111111111111111111111111111111111
1C1000C00000000C1F000C000000000001
1010F10100100000101001000110010101
101111001010101000100111100C010111
10P000000C00C010000000000000F000E1
1111111111111111111111111111111111
